22222222222222222
50100011000111113
31000110111001113
30110000111100113
31101111011011003
31101001011111113
30011011101001013
30011011101001013
30111100111111113
30011011011111013
31100011011000003
30011111000111103
30100111110111107
22222222222222222
